****************************************************************
*         *           *                                       E*
*    *    *  ***       *        * *                            *
*    *    *    *        *      *   *                           *
*    *    *    *         *    *     *        *                 *
*    *    *    *          *  *       *       *                 *
*S   *         *            *         *      *                 *
****************************************************************
